    ____             _                 _          ____                                   
   / __ \___  ____  (_)___  ___  ____ ( )_____   / __ \__  ______  ____ ____  ____  ____ 
  / / / / _ \/ __ \/ /_  / / _ \/ __ \|// ___/  / / / / / / / __ \/ __ `/ _ \/ __ \/ __ \
 / /_/ /  __/ / / / / / /_/  __/ / / / (__  )  / /_/ / /_/ / / / / /_/ /  __/ /_/ / / / /
/_____/\___/_/ /_/_/ /___/\___/_/ /_/ /____/  /_____/\__,_/_/ /_/\__, /\___/\____/_/ /_/ 
                                                                /____/                   