 _______  _______  ______    ___   _______  _______  __  
|       ||       ||    _ |  |   | |       ||       ||  | 
|  _____||_     _||   | ||  |   | |    ___||    ___||  | 
| |_____   |   |  |   |_||_ |   | |   |___ |   |___ |  | 
|_____  |  |   |  |    __  ||   | |    ___||    ___||__| 
 _____| |  |   |  |   |  | ||   | |   |    |   |___  __  
|_______|  |___|  |___|  |_||___| |___|    |_______||__| 